Maze1.txt 10 10
#
*** ******
**   *  **
*  *   ***
** ** ****
** * **  *
** * ** **
**   *  **
*      ***
* ** * ***
* ****   *
**********