Maze2.txt 20 16
#
**** ***************
**** ****** ********
*  * ******   ******
** * ****** *   ****
*  * ********** ****
* ** ***** **** ****
*               ****
* ** *****  ********
**** *      ********
*  * ***************
* ** **    ****   **
*      *  ***** * **
****   *        * ** 
**** *  **** **** **
****   * ***    ****
********************