Maze5.txt 10 14
#
**********
*****    *
*   * * **
* * * * **
* * * * **
  *** * **
* *** * **
*     * **
*** ******
*** *** **
* *   * **
* * *** **
* * *** **
*   *** **
* ********