Maze4.txt 25 06
#
*************************
    *    * *    *** ** **
* *** ** * *  *  *     **
*  *   *       * **** ***
*    **********       ***
*************************