Maze3.txt 08 12
#
********
*      *
* ******
* ******
*   ****
***   **
*** * **
**  * **
** *  **
   * * *
****   *
********